R 720 480

NO ./textures/mur1.xpm
SO ./textures/mur2.xpm
WE ./textures/sol.xpm
EA ./textures/wolf/redbrick.xpm

S ./textures/wolf/barrel.xpm
C 0,225,243
F 224,205,169

111111111111111111111111
100000000000000000000001
100000000000000000000001
100000011111111100000001
100000000000000000000001
100000000000000000000001
100000000000000000000001
100000000000000000000001
100000000000000000000001
100000000000000000000001
100011000000000000010001
100011100000N00000001001
100000000000000000010001
100000000000000000000001
100000000000000000000001
100000000000000000000001
100001111100000000000001
100000000000000000000001
100000000000000000000001
100000000000000000000001
100000000000000000000001
100000000000000000000001
100000000000000000000001
111111111111111111111111
