R 1280 720

NO ./textures/redbrick.xpm
SO ./textures/bluestone.xpm
WE ./textures/greystone.xpm
EA ./textures/wood.xpm

S ./textures/wolf/barrel.xpm
C 0,225,243
F 224,254,169

111111111111111111111111
100000000000000000000001
100000000000000000000001
100000000000000000000001
100000000000000000000001
100000000000000000000001
100000000000000010000001
101111101111101110110N01
100001000010000000010001
111111111111111111111111
