R 1280 720

NO ./textures/mur1.xpm
SO ./textures/mur2.xpm
WE ./textures/sol.xpm
EA ./textures/wolf/redbrick.xpm

S ./textures/wolf/barrel.xpm
C 0,225,243
F 224,254,169

111111111111111111111111
100000000000000000000001
100000000000000000000001
100000000000000000000001
100000000000N00000000001
100000000000000000000001
100000000000000000000001
100000000000000000000001
100000000000000000000001
111111111111111111111111
