R 1120 720

NO ./textures/redbrick.xpm
SO ./textures/bluestone.xpm
WE ./textures/colorstone.xpm
EA ./textures/wood.xpm

S ./textures/barrel.xpm
C 0,225,243
F 237,127,16

111111111111111111111111
100000020001122000000001
100110000001122000011001
100011002201100000110001
100001111111111111100001
100000000001100000000001
111111110001100011111111
120000010001100010000001
111110010011110010011111
100000000001100000000001
110011000001100000110011
100021000000000000100001
100021000000000000100001
100021011000E00110100001
100021021000000100122221
111111111110011111111111
100000000100001000002221
100020000000000000000021
100000000100001000002221
111111111110011111111111
122000000010010000000221
100001110010000011100001
122001110000010000000221
111111111111111111111111
