R 1280 720

NO ./textures/mur1.xpm
SO ./textures/mur2.xpm
WE ./textures/sol.xpm
EA ./textures/wolf/redbrick.xpm

S ./textures/wolf/barrel.xpm
C 0,225,243
F 224,205,169

        111111111111111111111111
        100000000000000000000001
        100000000000000111111111
111111111000000000000001
100000000000000000000001
100000000000000000000001
100000000000000000000001
100000000000000000000001
100000000000000000000001
111111110000000000000001
100000010000000000000001
100101011101111101111111
100101000000000001000001
111101111101111111000001
100000000100000000000001
100110111111110111111111
100100010000000000000001
10010N010000000000000001
100100010000000000000001
100110110000000000000001
100000000000000000000001
100000000000000000000001
100000000000000000000001
111111111111111111111111
